NO  ./assets/hedge_n.png
EA  ./assets/hedge_e.png
SO  ./assets/hedge_s.png
WE  ./assets/hedge_w.png

C 64-128-255
F 192,128,64


 111
 1010  0 1
 111

   11111
1111X001
10000101
100N0111
111111

