


 111
 1010  0 1
 111

   11111
11110001
10S00101
100N0111
111111

