


 111
 1010  0 1
 111

   11111
11110000
10000101
100N0111
111111

