NO  ./assets/hedge_n.png
EA  ./assets/hedge_e.png
SO  ./assets/hedge_s.png
WE  ./assets/hedge_w.png

C 64-128-255
F 192,128,64

1111111111111111111111111111111111111111
1000000010000000001000100010000000000001
1000000010000100001000100010000000000001
1000000010000100001000100000000000000001
1000011110000100001000000100000000000001
1000000010000100001000000100000000000001
1000000010000000001000000000000000000001
1000000000000000000000111111100000000001
1000000101010101000000100000010000000001
1000011010101010100000100101000000000001
1000010000000000010000001000010000000001
1000000000000000000010010000001000000001
1000000000000000000010000000000000000001
1000111001000000000010000000001111000001
1000101111000000001000100000001011000001
1000000110000000000111000000001010000001
1000000001100000000000000000011000000001
1000000000111000000000000011100000000001
1000000000000001100000011000000000000001
1000000000000000001111100000000000000001
1000000000000000000000000000000000000001
1111111111111111111111111111111111111111