

NO  ./assets/face_1.png
SO  ./assets/side_1.png
WE  ./assets/side_1.png
EA  ./assets/face_1.png

F 220,100,0
C 225-30-0

111111111
100000001
100000001
100000001
100W00001
100000001
111111111

