NO  ./assets/hedge_n.png
EA  ./assets/hedge_e.png
SO  ./assets/hedge_s.png
WE  ./assets/hedge_w.png

C 64-128-255
F 192,128,64

        1111111111111111111111111
        10000100001100000000000011
        1011000001100000000S000001
        10010000000000010000000001
111111110011000000110000100000101
100000000011100011100000000001101
100100111111010000000100000000001
11110011   1010111010000110011111
11000001111101011100000010001
100000000000000011000000100011
1000000000000000000101001000001
1000000111010101111101111000001
10110111 1110101010000000000111
11111111 11111011111111111111
             111
