

NO  ./assets/face_1.png
SO  ./assets/side_1.png
WE  ./assets/side_1.png
EA  ./assets/face_1.png

F 220,100,0
C 225-30-0

11111
10001
10E01
10001
11111

