NO  ./assets/hedge_n.png
EA  ./assets/hedge_e.png
SO  ./assets/hedge_s.png
WE  ./assets/hedge_w.png

C 64-128-255
F 192,128,64

1111111111111111111111111111111111111111
1000000000000000000000000000000000000001
1000000000000000000000000000000000000001
1000000000000000000000000000000000000001
1000000000000000000000000000000000000001
1000000000000000000000000000000000000001
1000000000000000000000000000000000000001
1000000000000000000000000000000000000001
1000000000000000000000000000000000000001
1000000000000000000000000000000000000001
1000000000000000000000000000000000000001
1000000000000000000000000000000000000001
1000000000000000000000000000000000000001
1000000000000000000000000000000000000001
1000000011100000000000000000001110000001
1000000000111000000000000000111000000001
1000000000011000000000000001100000000001
1000000000000111000000001110000000000001
1000000000000000110000110000000000000001
1000000000000000001111000000000000000001
1000000000000000000000000000000000000001
1111111111111111111111111111111111111111