


111
101
111
   11111
11110001
10000101
100N0111
111111

