

   11111
   10001
11110101
10000111
111111

